1   1   1   1   1   1   1   1   1   1
1   0   0   0   0   0   0   0   0   1
1   0   s   0   p   0   0   c   0   1
2   0   0   d   0   0   0   0   0   2
2  b,l  0   0   0   0  d,l  1   1   1
2   2   2   2   0   2   2   0   0   1
2   f   0   0   0   0   0   0   0   1
2   2   2   2   2   2   2   2   2   2