2 2 2 2 2 2 2 2 2 2 2 2 2 2 2 2 2
2 d 0 0 1 0 0 0 0 0 0 s 1 0 0 f 2
2 1 1 0 1 0 1 1 1 1 1 1 1 0 0 0 2
2 0 0 0 1 0 0 0 0 0 0 0 0 0 0 0 2
2 0 1 1 1 1 1 1 1 1 1 0 1 1 1 1 2
2 0 1 0 0 0 0 0 0 l 1 0 0 0 0 l 2
2 0 1 0 1 0 1 1 1 0 1 1 1 1 1 0 2
2 0 0 0 1 0 0 l 1 0 1 l 0 0 0 0 2
2 1 1 1 1 1 1 0 1 0 1 0 1 1 1 0 2
2 0 0 0 0 0 l 0 1 0 1 0 1 b 1 0 2
2 0 1 1 0 1 1 0 1 0 1 0 1 0 0 0 2
2 0 c 1 0 0 1 0 1 0 0 0 1 0 0 0 2
2 1 1 1 1 0 1 0 1 1 1 0 1 1 1 1 2
2 0 0 0 0 0 1 0 1 0 0 0 1 d 0 0 2
2 0 1 1 1 1 1 0 1 0 1 1 1 1 1 0 2
2 0 0 0 1 0 0 0 1 0 0 0 0 0 1 0 2
2 1 1 0 1 0 1 1 1 1 1 1 1 0 1 0 2
2 p 0 0 1 0 0 0 0 0 0 s 1 0 0 0 2
2 2 2 2 2 2 2 2 2 2 2 2 2 2 2 2 2
